1111111111111111
10P100ECCCCCCCC1
1111111111111111
