11111111111111111111111111111111
11011000110000111111011111010111
11001111100110001001001001C11101
11101000000011101001001011010101
10101110110110101101011010010111
11100000100100100001110011010001
11001110111110100100011001011101
10010000000000110111000001000111
10110011111111010001111101110011
10001110000000011100000100011011
11101010101111100010111101000011
10100011101010000110001001101011
11101000011010111100011001001111
11001001110011100001110111000101
11101010000000000111000001011101
10101010111111101101101111010011
11111010001000100000100010010011
11010011101110111110101110110011
10010100100010000011100100100111
11110100011011011000011111111101
11000100001000110010010000000111
11110011101110011011110111100011
11010000100010001100001100101111
11010110111010100110111000101001
11011100100010100011101101101011
1100000101111010P000000101001111
11010111000100111101110101100011
11110101101100100111011000111011
10100100001011111000001110101011
11110110111010000011100010001011
1101E011101110111110111111111011
11111111111111111111111111111111