1111111111111111111
1CCCCCCCCCCCCCCCCC1
1C111111C1C111111C1
1C1CCCCCC1CCCCCC0C1
1CCC1C11CCC1101CCC1
11111C1111111011111
10CCCC11111110000C1
1011111111111111111
1CCCCCCCCCCCCCCCCC1
1C111111C1C111111C1
1C1CCCCCC1CCCCCC1C1
1CCC1C11CCC1101CCC1
11111C1111111011111
10CCCC11111110000C1
1011111111111111111
1CCCCCCCCCCCCCCCCC1
1C111111C1C111111C1
1C1CCCCCC1CCCCCC1C1
1CCC1C11CCC1101CCC1
11111C1111111011111
1PCCC01111110000CE1
1111111111111111111