1111111111
1PC0C00011
10000000E1
1111111111