1111111111111
101101C00C011
10101P1111111
101E11000E001
1111111111111