1111111111111
100100C00C011
100P011111111
100E000000001
1111111111111