1111111111111
10C1000000E01
1000011111001
1P00110000001
1111111111111